++#+++++##+#++++#+++
++++##+##++#++#+#+++
++++#+#+++#++#+#+#++
+#+++++#d++#++++++++
++h+++++###+#e#++#+#
+++++#+++#++++++++++
+#+#+#++++#+++++#+++
+#++#+##+++#++++##+#
#++##+#++$+++#+++g+#
+####+++++++#+++###+
++#++++++##++++++#+#
f+++#+++#+++#b++#+#+
++#+++++++++++++++++
+++##a#+#+++++##+++#
#++#++++++++++++++++
+##++#+#+++#++#+++++
##+++++++++++++#++++
++++++##+c++##++++##
+###++++++++#++#++#+
++++++++++++++++#+#+
