#+#+$++++#
+#++#+###+
a+###++#++
+#++#+b+#+
#+c+#+++##
++#+##++++
##+#+##+++
++++#e#+##
++#++##+#+
d####+++#+
